%%%%%%%%%%%%%%%%%%%%%%%%%%%%%
%P         %        %       %
%         %                 %
%   %%%%%      %         %  %
%         %                 %
%    %     .     %          %
%         %                 %
%    %%%%      %   %%%%     %
%         %                 %
%%%%%%%%%%%%%%%%%%%%%%%%%%%%%
